emerging markets - развивающиеся рынки
trade fairs - ярмарки, выставки 
get across - четко изложить
profit - прибыль, доход, барыш, профит  (income, grist); выгода, польза; (benefit); нажива (gain)
easy profit - легкая нажива
lost profit - упущенная выгода
spiritual profit - духовная польза
taxable profit - налогооблагаемая прибыль
balance sheet profit - балансовая прибыль
operating profit margin - маржа операционной прибыли
profit before income tax - прибыль до налогообложения
make huge profits - получать огромные прибыли
bring a good profit - приносить хорошую прибыль
part of its profit - часть прибыли
maximum profit - максимальная прибыль
net profit - чистый доход
monetary - денежный, валютный, монетарный, финансовый (cash, currency, financial)
tight monetary policy - жесткая денежная политика
payment of monetary compensation - выплата денежной компенсации
new monetary system - новая денежная система
international monetary fund - международный валютный фонд
monetary gold - монетарное золото
monetary stability - финансовая стабильность


1 steadily improving balance sheet
	неуклонное улучшение баланса
2 ambitious market research programme
	амбициозная программа исследований рынка
3 new public relations department
	новый отдел связей с общественностью
4 extremely impressive profit figures
	чрезвычайно впечатляющие показатели прибыли
5 rapidly expanding overseas operations
	быстрое расширение зарубежных операций

target market	целевой рынок, целевая аудитория
youth market 	молодежный рынок
market segmentation	сегментация рынка, сегментирование рынка, рыночная сегментация
market share	 доля рынка, рыночная доля, доля участия


niche marketing	нишевой маркетинг
global marketing	глобальный маркетинг
marketing campaign	маркетинговая/рекламная кампания
marketing budget	    маркетинговый бюджет, бюджет маркетинга

fair trade	торговля на основе взаимной выгоды (контрабанда)
world trade	международная торговля
trade fair	выставка-ярмарка
trade deficit	торговый дефицит

outdoor advertising	наружная реклама
Internet advertising	реклама в интернете
advertising campaign	рекламная кампания/акция
advertising agency	рекламное агентство

premium brand	премиальный бренд, премиальная марка
leading brand	ведущий бренд, ведущая торговая марка
brand image	имидж бренда, образ бренда
brand name	марка, бренд, торговая марка, фирменный знак, товарный знак

