unit 1
articulate	артикулировать -ясно выражать (про выражение мыслей, express ideas clearly&nicely, clear undertsndable)
concise	краткий сжатый четкий сокращенный выразительный немногословный (logical, connect ideas logically)
focused	фокусированный 
reserved	сдержанный замкнутый скрытный зарезервированный резервный запасной необщительный осторожный (modest, who waits his turn)
coherent	понятный ясный разборчивый связный сцепленный последовательный 
hesitant	нерешительный колеблющийся сомневающийся заикающийся (но действующий, yes/no)
responsive	отзывчивый ответный чуткий -легко реагирующий (react to others)
eloquent	красноречивый выразительный (about quality of words, uses nice words&iidoms, clear undertsndable&nice)
inhibited	заторможенный замкнутый (very shy, not confident, более стеснительный чем hesitant, настолько что даже ничего не может сделать)
sensitive	чувствительный чуткий деликатный восприимчивый щекотливый точный впечатлительный 
extrovert	экстроверт -человек без духовных интересов
persuasive	убедительный побуждение мотив 
succint	краткое -Краткое изложение
succinct	краткий сжатый опоясанный (brief, concise)
brief	succinct & concise
fluent	беглый текучий гладкий плавный -владеющий речью (think on one's feet, quick on making decisions)
rambling	(когда скачет с одного на другое, но понять суть в итоге можно)
ramble	бессвязный хаотичный беспорядочный разбросанный бродячий слоняющийся ползучий 
vague	неопределенный расплывчатый неясный смутный рассеянный неуловимый отсутствующий [veig] (когда не понять в итоге никакой сути/конкретики)
reluctant	неохотный вынужденный сопротивляющийся упорный -не поддающийся чему-л.
outgoing	общительный дружелюбный отзывчивый исходящий уходящий отбывающий уезжающий -издержки 
eager	нетерпеливый стремящийся энергичный острый горячий напряженный -полный страстного желания -сильно желающий

clarify	прояснить очищать просветлять -вносить ясность -делать прозрачным
confuse	смешивать смущать спутывать -сбивать с толку -создавать путаницу -приводить в замешательство -приводить в беспорядок -помрачать сознание
digress	отвлекаться отклоняться отступать 
engage	заниматься привлекать вступать зацепляться обязывать -завладевать вниманием
explain	объяснять растолковать оправдывать 
interrupt	прерывание перебивать мешать вмешиваться препятствовать преграждать 
ramble	заговариваться путаница бред  -бродить (без цели,для удовольствия) -болтать чепуху -говорить бессвязно
elaborate	сложный продуманный уточнять конкретизировать -детально,тщательно  разработанный
inherent	свойственный присущий неотъемлемый врожденный 
cope with	ладить с, справляться с
bandwidth	пропускная способность
particularly	особым образом, в частности, особенно очень чрезвычайно подробно индивидуально 

impetuous	импульсивный пылкий бушующий стремительный порывистый 
irritable	раздражительный болезненный -воспринимающий раздражение
fester	твердый жесткий крепкий плотный прочный упругий тугой непоколебимый устойчивый 
make things up	сделать все
invariably	неизменно 
bizarre	странно необычное причудливый
DISTRACTION	отвлечение рассеянность растерянность смятение безумие сумасшествие -то, что отвлекает внимание
reprimand	выговор замечание встрепка -делать выговор -объявлять выговор
peek 	заглядывать -быстрый взгляд -взгляд украдкой
board meeting	заседание совета директоров
gross form	
hypocrisy	лицемерие притворство 
I once threatened	Я когда-то угрожал
sling	ремень праща канат лямки рогатка метать швырять подвешивать -вешать через плечо 
sling out of window	-выбрасывать из окна
I chaired	Я председательствовал
uncivil	невежливый грубый нецивилизованный -непатриотически настроенный
swiftly	быстро
marvellously	изумительно
far-flung	-широко раскинувшийся
discreetly	благоразумно
pitch	

bush	куст кустарник втулка гильза чаща таверна -ветка плюща -густые волосы -густо разрастаться
grapevine	-виноградная лоза -ложные слухи -способ тайного сообщения
loop	петля виток скоба спираль хомут -нервный узел -обгонный путь
mouth	рот уста отверстие горлышко вход жерло рупор -устье реки нахальство болтливость 
nutshell	ореховая скорлупа
stick	держаться придерживаться втыкать вкалывать застревать увязнуть оставаться липнуть колоть вонзать озадачивать всучить навязать
stick	палка ручка трость прут брусок ветка мебель трепало наказание порка тупица -недалекий человек
tail	хвост конец -задняя часть, косичка остатки свита, выслеживать -подрезать хвост
wavelength	длина волны